##############
#.@..........#
#.........####
###+#######..#
#............#
##############