##############
#.@..........#
#.........####
###+#######..#
#......g.....#
#............#
#....e.......#
#............#
#............#
##############