##############
#.@...o......#
#.#.#.....####
###+#######..#
#......#.....#
#.#.......#..#
#....P..g....#
#.#.......#..#
#............#
##############
